0000020000
0000020000
0000020000
0000020000
0311160000
0200000000
0411111150
0000000020
0311111160
0200000000
